xxxxxxxxxxxxxxxx|xxxxxxxxxxxxxxxx|xxxxxxxxxxxxxxxx|xxxxxxxxxxxxxxxx|xxxxxxxxxxxxxxxx|xxxxxxxxxxxxxxxx|xxxxxxxxxxxxxxxx|                |                |                |                |                |                |                |                |                |
xxxxxxxxxxxxxxxx|xxxxxxxxxxududxx|xxxxxxxxxxxxxxxx|xudxxxxxxxxxxxxx|xxxxxxxxxxxxgxxx|xxxxxxxxxxxxxxxx|xxxxxxxudxxxxxxx|                |                |                |                |                |                |                |                |                |
xxxxxxxxxxxxxxxx|xxdxxxxxx     xx|xxxxxxxxxxudxxxx|x  dxxxxxxxxxxxx|xxxxxxxxxxu    d|udu           dx|xxxxudu  dxxxxxx|                |                |                |                |                |                |                |                |                |
xxxxxxxxxxxxxxxx|xu xxxxxx     dx|xxxxxxxxxx  dxxx|x   dxxxxxxxxxxx|xxxxxxxxxu      |    UD    UD   x|xxxu      xxxxxx|                |                |                |                |                |                |                |                |                |
xxxxxxxxxxxxxxxx|x  dudxxu      d|xxxxxxxxxu   dxx|u    dxxxxxxxxxx|xxxxudxxu       |   UxxD  UxxD  d|udu       dududx|                |                |                |                |                |                |                |                |                |
xxxxxxx         |                |                |           xxxxx|xu    du        |   xxxx  xxxx   |                |                |                |                |                |                |                |                |                |                |
xxxxxxxlxxxxxxxx|x              U|xxxlxxxxxD      |     Uxxxxlxxxxx|x               |   dxxu  dxxu  U|DUD       UDUDUx|                |                |                |                |                |                |                |                |                |
xxxxxxxlxxxxxxxx|xD            Ux|xxxlxxxxxx      |    Uxxxxxlxxxxx|x               |               x|xxxD      xxxxxx|                |                |                |                |                |                |                |                |                |
xxxxxxxlxxxxxxxx|xx            xx|xxxlxxxxxxD     |   Uxxxxxxlxxxxx|xD    UD       U|DUD           Ux|xxxxDUD  Uxxxxxx|                |                |                |                |                |                |                |                |                |
xxxxxxxlxxxxxxxx|xxxxxxxlxxxxDUxx|xxxlxxxxxxxxxxxx|xxxxxxxxxxxxxxxx|xxxxxxxxxxxxxxxx|xxxxxxxxxxxxxxxx|xxxxxxxDUxxxxxxx|                |                |                |                |                |                |                |                |                |
xxxxxxxlxxxxxxxx|xxxxxxxlxxxxxxxx|xxxlxxxxxxxxxxxx|xxxxxxxxxxxxxxxx|xxxxxxxxxxxxxxxx|xxxxxxxxxxxxxxxx|xxxxxxxxxxxxxxxx|                |                |                |                |                |                |                |                |                |
----------------+----------------+----------------+----------------+----------------+----------------+----------------+----------------+----------------+----------------+----------------+----------------+----------------+----------------+----------------+----------------+
                |                |                |                |                |                |                |                |                |                |                |                |                |                |                |                |
                |                |                |                |                |                |                |                |                |                |                |                |                |                |                |                |
                |                |                |                |                |                |                |                |                |                |                |                |                |                |                |                |
                |                |                |                |                |                |                |                |                |                |                |                |                |                |                |                |
                |                |                |                |                |                |                |                |                |                |                |                |                |                |                |                |
                |                |                |                |                |                |                |                |                |                |                |                |                |                |                |                |
                |                |                |                |                |                |                |                |                |                |                |                |                |                |                |                |
                |                |                |                |                |                |                |                |                |                |                |                |                |                |                |                |
                |                |                |                |                |                |                |                |                |                |                |                |                |                |                |                |
                |                |                |                |                |                |                |                |                |                |                |                |                |                |                |                |
                |                |                |                |                |                |                |                |                |                |                |                |                |                |                |                |
----------------+----------------+----------------+----------------+----------------+----------------+----------------+----------------+----------------+----------------+----------------+----------------+----------------+----------------+----------------+----------------+
                |                |                |                |                |                |                |                |                |                |                |                |                |                |                |                |
                |                |                |                |                |                |                |                |                |                |                |                |                |                |                |                |
                |                |                |                |                |                |                |                |                |                |                |                |                |                |                |                |
                |                |                |                |                |                |                |                |                |                |                |                |                |                |                |                |
                |                |                |                |                |                |                |                |                |                |                |                |                |                |                |                |
                |                |                |                |                |                |                |                |                |                |                |                |                |                |                |                |
                |                |                |                |                |                |                |                |                |                |                |                |                |                |                |                |
                |                |                |                |                |                |                |                |                |                |                |                |                |                |                |                |
                |                |                |                |                |                |                |                |                |                |                |                |                |                |                |                |
                |                |                |                |                |                |                |                |                |                |                |                |                |                |                |                |
                |                |                |                |                |                |                |                |                |                |                |                |                |                |                |                |
----------------+----------------+----------------+----------------+----------------+----------------+----------------+----------------+----------------+----------------+----------------+----------------+----------------+----------------+----------------+----------------+
                |                |                |                |                |                |                |                |                |                |                |                |                |                |                |                |
                |                |                |                |                |                |                |                |                |                |                |                |                |                |                |                |
                |                |                |                |                |                |                |                |                |                |                |                |                |                |                |                |
                |                |                |                |                |                |                |                |                |                |                |                |                |                |                |                |
                |                |                |                |                |                |                |                |                |                |                |                |                |                |                |                |
                |                |                |                |                |                |                |                |                |                |                |                |                |                |                |                |
                |                |                |                |                |                |                |                |                |                |                |                |                |                |                |                |
                |                |                |                |                |                |                |                |                |                |                |                |                |                |                |                |
                |                |                |                |                |                |                |                |                |                |                |                |                |                |                |                |
                |                |                |                |                |                |                |                |                |                |                |                |                |                |                |                |
                |                |                |                |                |                |                |                |                |                |                |                |                |                |                |                |
----------------+----------------+----------------+----------------+----------------+----------------+----------------+----------------+----------------+----------------+----------------+----------------+----------------+----------------+----------------+----------------+
                |                |                |                |                |                |                |                |                |                |                |                |                |                |                |                |
                |                |                |                |                |                |                |                |                |                |                |                |                |                |                |                |
                |                |                |                |                |                |                |                |                |                |                |                |                |                |                |                |
                |                |                |                |                |                |                |                |                |                |                |                |                |                |                |                |
                |                |                |                |                |                |                |                |                |                |                |                |                |                |                |                |
                |                |                |                |                |                |                |                |                |                |                |                |                |                |                |                |
                |                |                |                |                |                |                |                |                |                |                |                |                |                |                |                |
                |                |                |                |                |                |                |                |                |                |                |                |                |                |                |                |
                |                |                |                |                |                |                |                |                |                |                |                |                |                |                |                |
                |                |                |                |                |                |                |                |                |                |                |                |                |                |                |                |
                |                |                |                |                |                |                |                |                |                |                |                |                |                |                |                |
----------------+----------------+----------------+----------------+----------------+----------------+----------------+----------------+----------------+----------------+----------------+----------------+----------------+----------------+----------------+----------------+
                |                |                |                |                |                |                |                |                |                |                |                |                |                |                |                |
                |                |                |                |                |                |                |                |                |                |                |                |                |                |                |                |
                |                |                |                |                |                |                |                |                |                |                |                |                |                |                |                |
                |                |                |                |                |                |                |                |                |                |                |                |                |                |                |                |
                |                |                |                |                |                |                |                |                |                |                |                |                |                |                |                |
                |                |                |                |                |                |                |                |                |                |                |                |                |                |                |                |
                |                |                |                |                |                |                |                |                |                |                |                |                |                |                |                |
                |                |                |                |                |                |                |                |                |                |                |                |                |                |                |                |
                |                |                |                |                |                |                |                |                |                |                |                |                |                |                |                |
                |                |                |                |                |                |                |                |                |                |                |                |                |                |                |                |
                |                |                |                |                |                |                |                |                |                |                |                |                |                |                |                |
----------------+----------------+----------------+----------------+----------------+----------------+----------------+----------------+----------------+----------------+----------------+----------------+----------------+----------------+----------------+----------------+
                |                |                |                |                |                |                |xxxxxxxxxxxxxxxx|                |                |                |                |                |                |                |                |
                |                |                |                |                |                |                |xxxxxxxxxxxxxxxx|                |                |                |                |                |                |                |                |
                |                |                |                |                |                |                |xu       du   dx|                |                |                |                |                |                |                |                |
                |                |                |                |                |                |                |u  x x      x  d|                |                |                |                |                |                |                |                |
                |                |                |                |                |                |                |                |                |                |                |                |                |                |                |                |
                |                |                |                |                |                |                |   x x      x   |                |                |                |                |                |                |                |                |
                |                |                |                |                |                |                |                |                |                |                |                |                |                |                |                |
                |                |                |                |                |                |                |D  x x      x  U|                |                |                |                |                |                |                |                |
                |                |                |                |                |                |                |xD       UD   Ux|                |                |                |                |                |                |                |                |
                |                |                |                |                |                |                |xxxxxxx  xxxxxxx|                |                |                |                |                |                |                |                |
                |                |                |                |                |                |                |xxxxxxx  xxxxxxx|                |                |                |                |                |                |                |                |
----------------+----------------+----------------+----------------+----------------+----------------+----------------+----------------+----------------+----------------+----------------+----------------+----------------+----------------+----------------+----------------+
                |                |                |                |                |                |                |xxxxxxx  xxxxxxx|                |                |                |                |                |                |                |                |
                |                |                |                |                |                |                |xxxxgxu  xxxxxxx|                |                |                |                |                |                |                |                |
                |                |                |                |                |                |                |xxxu     xxxxxxx|                |                |                |                |                |                |                |                |
                |                |                |                |                |                |                |xxu      xxxxxxx|                |                |                |                |                |                |                |                |
                |                |                |                |                |                |                |xu       dxxxxxx|                |                |                |                |                |                |                |                |
                |                |                |                |                |                |                |                |                |                |                |                |                |                |                |                |
                |                |                |                |                |                |                |xD            xx|                |                |                |                |                |                |                |                |
                |                |                |                |                |                |                |xx            xx|                |                |                |                |                |                |                |                |
                |                |                |                |                |                |                |xx            xx|                |                |                |                |                |                |                |                |
                |                |                |                |                |                |                |xxxxxxxxxxxxxxxx|                |                |                |                |                |                |                |                |
                |                |                |                |                |                |                |xxxxxxxxxxxxxxxx|                |                |                |                |                |                |                |                |
----------------+----------------+----------------+----------------+----------------+----------------+----------------+----------------+----------------+----------------+----------------+----------------+----------------+----------------+----------------+----------------+







































































