xxxxxxxxxxxxxxxx|xxxxxxxxxxxxxxxx|xxxxxxxxxxxxxxxx|xxxxxxxxxxxxxxxx|xxxxxxxxxxxxxxxx|xxxxxxxxxxxxxxxx|xxxxxxxxxxxxxxxx|xxxxxxxxxxxxxxxx|xxxxxxxxxxxxxxxx|xxxxxxxxxxxxxxxx|xxxxxxxxxxxxxxxx|xxxxxxxxxxxxxxxx|xxxxxxxxxxxxxxxx|                |                |                |
xxxxxxxxxxxxxxxx|xxxxxxxxxxududxx|xxxxxxxxxxxxxxxx|xudxxxxxxxxxxxxx|xxxxxxxxxxxxgxxx|xxxxxxxxxxxxxxxx|xxxxxxxudxxxxxxx|xxxxxxxxxxxxxxxx|xxxxxxxudxxxxxxx|xxxxxxxxxxxxxxxx|xxgxxxxxxxxxxxxx|xxxxxxxxxxxxudxx|xxxxxxxxgxudxxxx|                |                |                |
xxxxxxxxxxxxxxxx|xxdxxxxxx     xx|xxxxxxxxxxudxxxx|x  dxxxxxxxxxxxx|xxxxxxxxxxu    d|udu           dx|xxxxudu  dxxxxxx|xxxxxxxxxxxxxxxx|xxxxudu  dxxxxxx|xudu         dxx|xu            dx|xxu           dx|xxxxxxxu    xxu |                |                |                |
xxxxxxxxxxxxxxxx|xu xxxxxx     dx|xxxxxxxxxx  dxxx|x   dxxxxxxxxxxx|xxxxxxxxxu      |    UD    UD   x|xxxu      xxxxxx|xxxxxxxudxxxxxxx|xxxu      xxxxxx|x     x       dx|x  xxxxxxxxx   x|xu    UxD      x|xxxxxxx     du  |                |                |                |
xxxxxxxxxxxxxxxx|x  dudxxu      d|xxxxxxxxxu   dxx|u    dxxxxxxxxxx|xxxxudxxu       |   UxxD  UxxD  d|udu       dududx|xxxxxxu  dxxudxx|udu       dududx|u    x         x|x  xxxxxxxxx   x|x  m mxgxm m   x|xxxxxxu         |                |                |                |
xxxxxxx         |                |                |           xxxxx|xu    du        |   xxxx  xxxx   |                |                |                |    x x x x x  x|x  xxxxxxxxx   x|x              x|xxxxx           |                |                |                |
xxxxxxxlxxxxxxxx|x              U|xxxlxxxxxD      |     Uxxxxlxxxxx|x               |   dxxu  dxxu  U|DUD       UDUDUx|xxxxlxD  UxxDUxx|DUD       UDUDUx|D    x         x|x  xxxxxxxxx   x|x  m m   m m   x|xxxxxlD         |                |                |                |
xxxxxxxlxxxxxxxx|xD            Ux|xxxlxxxxxx      |    Uxxxxxlxxxxx|x               |               x|xxxD      xxxxxx|xxxxlxxDUxxxxxxx|xxxD      xxxxxx|x     x       Ux|x     x        x|xD             x|xxxxxlx     UD  |                |                |                |
xxxxxxxlxxxxxxxx|xx            xx|xxxlxxxxxxD     |   Uxxxxxxlxxxxx|xD    UD       U|DUD           Ux|xxxxDUD  Uxxxxxx|xxxxlxxxxxxxxxxx|xxxxDUD  Uxxxxxx|xDUD         Uxx|xD    x       Ux|xxD           Ux|xxxxxlxD    xxD |                |                |                |
xxxxxxxlxxxxxxxx|xxxxxxxlxxxxDUxx|xxxlxxxxxxxxxxxx|xxxxxxxxxxxxxxxx|xxxxxxxxxxxxxxxx|xxxxxxxxxxxxxxxx|xxxxxxxDUxxxxxxx|xxxxlxxxxxxxxxxx|xxxxxxxDUxxxxxxx|xxxxxxxxxxxxxxxx|xxxxxxxxxxxxxlxx|xxxxxxxlxxxxxxxx|xxxxxlxxxxDUxxxx|                |                |                |
xxxxxxxlxxxxxxxx|xxxxxxxlxxxxxxxx|xxxlxxxxxxxxxxxx|xxxxxxxxxxxxxxxx|xxxxxxxxxxxxxxxx|xxxxxxxxxxxxxxxx|xxxxxxxxxxxxxxxx|xxxxlxxxxxxxxxxx|xxxxxxxxxxxxxxxx|xxxxxxxxxxxxxxxx|xxxxxxxxxxxxxlxx|xxxxxxxlxxxxxxxx|xxxxxlxxxxxxxxxx|                |                |                |
----------------+----------------+----------------+----------------+----------------+----------------+----------------+----------------+----------------+----------------+----------------+----------------+----------------+----------------+----------------+----------------+
                |                |                |                |                |                |                |                |                |                |                |                |                |                |                |                |
                |                |                |                |                |                |                |                |                |                |                |                |                |                |                |                |
                |                |                |                |                |                |                |                |                |                |                |                |                |                |                |                |
                |                |                |                |                |                |                |                |                |                |                |                |                |                |                |                |
                |                |                |                |                |                |                |                |                |                |                |                |                |                |                |                |
                |                |                |                |                |                |                |                |                |                |                |                |                |                |                |                |
                |                |                |                |                |                |                |                |                |                |                |                |                |                |                |                |
                |                |                |                |                |                |                |                |                |                |                |                |                |                |                |                |
                |                |                |                |                |                |                |                |                |                |                |                |                |                |                |                |
                |                |                |                |                |                |                |                |                |                |                |                |                |                |                |                |
                |                |                |                |                |                |                |                |                |                |                |                |                |                |                |                |
----------------+----------------+----------------+----------------+----------------+----------------+----------------+----------------+----------------+----------------+----------------+----------------+----------------+----------------+----------------+----------------+
                |                |                |                |                |                |                |                |                |                |                |                |                |                |                |                |
                |                |                |                |                |                |                |                |                |                |                |                |                |                |                |                |
                |                |                |                |                |                |                |                |                |                |                |                |                |                |                |                |
                |                |                |                |                |                |                |                |                |                |                |                |                |                |                |                |
                |                |                |                |                |                |                |                |                |                |                |                |                |                |                |                |
                |                |                |                |                |                |                |                |                |                |                |                |                |                |                |                |
                |                |                |                |                |                |                |                |                |                |                |                |                |                |                |                |
                |                |                |                |                |                |                |                |                |                |                |                |                |                |                |                |
                |                |                |                |                |                |                |                |                |                |                |                |                |                |                |                |
                |                |                |                |                |                |                |                |                |                |                |                |                |                |                |                |
                |                |                |                |                |                |                |                |                |                |                |                |                |                |                |                |
----------------+----------------+----------------+----------------+----------------+----------------+----------------+----------------+----------------+----------------+----------------+----------------+----------------+----------------+----------------+----------------+
                |                |                |                |                |                |                |                |                |                |                |                |                |                |                |                |
                |                |                |                |                |                |                |                |                |                |                |                |                |                |                |                |
                |                |                |                |                |                |                |                |                |                |                |                |                |                |                |                |
                |                |                |                |                |                |                |                |                |                |                |                |                |                |                |                |
                |                |                |                |                |                |                |                |                |                |                |                |                |                |                |                |
                |                |                |                |                |                |                |                |                |                |                |                |                |                |                |                |
                |                |                |                |                |                |                |                |                |                |                |                |                |                |                |                |
                |                |                |                |                |                |                |                |                |                |                |                |                |                |                |                |
                |                |                |                |                |                |                |                |                |                |                |                |                |                |                |                |
                |                |                |                |                |                |                |                |                |                |                |                |                |                |                |                |
                |                |                |                |                |                |                |                |                |                |                |                |                |                |                |                |
----------------+----------------+----------------+----------------+----------------+----------------+----------------+----------------+----------------+----------------+----------------+----------------+----------------+----------------+----------------+----------------+
                |                |                |                |                |                |                |                |                |                |                |                |                |                |                |                |
                |                |                |                |                |                |                |                |                |                |                |                |                |                |                |                |
                |                |                |                |                |                |                |                |                |                |                |                |                |                |                |                |
                |                |                |                |                |                |                |                |                |                |                |                |                |                |                |                |
                |                |                |                |                |                |                |                |                |                |                |                |                |                |                |                |
                |                |                |                |                |                |                |                |                |                |                |                |                |                |                |                |
                |                |                |                |                |                |                |                |                |                |                |                |                |                |                |                |
                |                |                |                |                |                |                |                |                |                |                |                |                |                |                |                |
                |                |                |                |                |                |                |                |                |                |                |                |                |                |                |                |
                |                |                |                |                |                |                |                |                |                |                |                |                |                |                |                |
                |                |                |                |                |                |                |                |                |                |                |                |                |                |                |                |
----------------+----------------+----------------+----------------+----------------+----------------+----------------+----------------+----------------+----------------+----------------+----------------+----------------+----------------+----------------+----------------+
                |                |                |                |                |                |                |                |                |                |                |                |                |                |                |                |
                |                |                |                |                |                |                |                |                |                |                |                |                |                |                |                |
                |                |                |                |                |                |                |                |                |                |                |                |                |                |                |                |
                |                |                |                |                |                |                |                |                |                |                |                |                |                |                |                |
                |                |                |                |                |                |                |                |                |                |                |                |                |                |                |                |
                |                |                |                |                |                |                |                |                |                |                |                |                |                |                |                |
                |                |                |                |                |                |                |                |                |                |                |                |                |                |                |                |
                |                |                |                |                |                |                |                |                |                |                |                |                |                |                |                |
                |                |                |                |                |                |                |                |                |                |                |                |                |                |                |                |
                |                |                |                |                |                |                |                |                |                |                |                |                |                |                |                |
                |                |                |                |                |                |                |                |                |                |                |                |                |                |                |                |
----------------+----------------+----------------+----------------+----------------+----------------+----------------+----------------+----------------+----------------+----------------+----------------+----------------+----------------+----------------+----------------+
                |                |                |                |                |                |                |xxxxxxxxxxxxxxxx|                |                |                |                |                |                |                |                |
                |                |                |                |                |                |                |xxxxxxxxxxxxxxxx|                |                |                |                |                |                |                |                |
                |                |                |                |                |                |                |xu       du   dx|                |                |                |                |                |                |                |                |
                |                |                |                |                |                |                |u  x x      x  d|                |                |                |                |                |                |                |                |
                |                |                |                |                |                |                |                |                |                |                |                |                |                |                |                |
                |                |                |                |                |                |                |   x x      x   |                |                |                |                |                |                |                |                |
                |                |                |                |                |                |                |                |                |                |                |                |                |                |                |                |
                |                |                |                |                |                |                |D  x x      x  U|                |                |                |                |                |                |                |                |
                |                |                |                |                |                |                |xD       UD   Ux|                |                |                |                |                |                |                |                |
                |                |                |                |                |                |                |xxxxxxx  xxxxxxx|                |                |                |                |                |                |                |                |
                |                |                |                |                |                |                |xxxxxxx  xxxxxxx|                |                |                |                |                |                |                |                |
----------------+----------------+----------------+----------------+----------------+----------------+----------------+----------------+----------------+----------------+----------------+----------------+----------------+----------------+----------------+----------------+
                |                |                |                |                |                |                |xxxxxxx  xxxxxxx|                |                |                |                |                |                |                |                |
                |                |                |                |                |                |                |xxxxgxu  xxxxxxx|                |                |                |                |                |                |                |                |
                |                |                |                |                |                |                |xxxu     xxxxxxx|                |                |                |                |                |                |                |                |
                |                |                |                |                |                |                |xxu      xxxxxxx|                |                |                |                |                |                |                |                |
                |                |                |                |                |                |                |xu       dxxxxxx|                |                |                |                |                |                |                |                |
                |                |                |                |                |                |                |                |                |                |                |                |                |                |                |                |
                |                |                |                |                |                |                |xD            xx|                |                |                |                |                |                |                |                |
                |                |                |                |                |                |                |xx            xx|                |                |                |                |                |                |                |                |
                |                |                |                |                |                |                |xx            xx|                |                |                |                |                |                |                |                |
                |                |                |                |                |                |                |xxxxxxxxxxxxxxxx|                |                |                |                |                |                |                |                |
                |                |                |                |                |                |                |xxxxxxxxxxxxxxxx|                |                |                |                |                |                |                |                |
----------------+----------------+----------------+----------------+----------------+----------------+----------------+----------------+----------------+----------------+----------------+----------------+----------------+----------------+----------------+----------------+







































































