xxxxxxxxxxxxxxxx|xxxxxxxxxxxxxxxx|xxxxxxxxxxxxxxxx|xxxxxxxxxxxxxxxx|xxxxxxxxxxxxxxxx|xxxxxxxxxxxxxxxx|xxxxxxxxxxxxxxxx|xxxxxxxxxxxxxxxx|xxxxxxxxxxxxxxxx|xxxxxxxxxxxxxxxx|xxxxxxxxxxxxxxxx|xxxxxxxxxxxxxxxx|xxxxxxxxxxxxxxxx|xxxxxxxxxxxxxxxx|xxxxxxxxxxxxxxxx|xxxxxxxxxxxxxxxx|
xxxxxxxxxxxxxxxx|xxxxxxxxxxududxx|xxxxxxxxxxxxxxxx|xudxxxxxxxxxxxxx|xxxxxxxxxxxxgxxx|xxxxxxxxxxxxxxxx|xxxxxxxudxxxxxxx|xxxxxxxxxxxxxxxx|xxxxxxxudxxxxxxx|xxxxxxxxxxxxxxxx|xxgxxxxxxxxxxxxx|xxxxxxxxxxxxudxx|xxxxxxxxgxudxxxx|xxxxxxudxxxxxxxx|xxxxxxxxxxxxxxxx|xxxxxxxxxxxxxxxx|
xxxxxxxxxxxxxxxx|xxdxxxxxx     xx|xxxxxxxxxxudxxxx|x  dxxxxxxxxxxxx|xxxxxxxxxxu    d|udu           dx|xxxxudu  dxxxxxx|xxxxxxxxxxxxxxxx|xxxxudu  dxxxxxx|xudu         dxx|xu            dx|xxu           dx|xxxxxxxu    xxu |  dxxu    dxxxxx|xxxxxxxxxxxxxxxx|xx            xx|
xxxxxxxxxxxxxxxx|xu xxxxxx     dx|xxxxxxxxxx  dxxx|x   dxxxxxxxxxxx|xxxxxxxxxu      |    UD    UD   x|xxxu      xxxxxx|xxxxxxxudxxxxxxx|xxxu      xxxxxx|x     x       dx|x  xxxxxxxxx   x|xu    UxD      x|xxxxxxx     du  |   du      dxxxx|xxxxxxxxxxxxxxxx|xx  UD UxD UD xx|
xxxxxxxxxxxxxxxx|x  dudxxu      d|xxxxxxxxxu   dxx|u    dxxxxxxxxxx|xxxxudxxu       |   UxxD  UxxD  d|udu       dududx|xxxxxxu  dxxudxx|udu       dududx|u    x         x|x  xxxxxxxxx   x|x  m mxgxm m   x|xxxxxxu         |            dxxx|xxxxxgxxxxxxxxxx|xx  xx xgx xx xx|
xxxxxxx         |                |                |           xxxxx|xu    du        |   xxxx  xxxx   |                |                |                |    x x x x x  x|x  xxxxxxxxx   x|x              x|xxxxx           |              dx|xxxxx xxxxxxxxxx|xx            xx|
xxxxxxxlxxxxxxxx|x              U|xxxlxxxxxD      |     Uxxxxlxxxxx|x               |   dxxu  dxxu  U|DUD       UDUDUx|xxxxlxD  UxxDUxx|DUD       UDUDUx|D    x         x|x  xxxxxxxxx   x|x  m m   m m   x|xxxxxlD         |               x|xxxxx xxxxxxxxxx|xx            xx|
xxxxxxxlxxxxxxxx|xD            Ux|xxxlxxxxxx      |    Uxxxxxlxxxxx|x               |               x|xxxD      xxxxxx|xxxxlxxDUxxxxxxx|xxxD      xxxxxx|x     x       Ux|x     x        x|xD             x|xxxxxlx     UD  |   UD          x|xxxxx xxxxxxxxxx|xx            xx|
xxxxxxxlxxxxxxxx|xx            xx|xxxlxxxxxxD     |   Uxxxxxxlxxxxx|xD    UD       U|DUD           Ux|xxxxDUD  Uxxxxxx|xxxxlxxxxxxxxxxx|xxxxDUD  Uxxxxxx|xDUD         Uxx|xD    x       Ux|xxD           Ux|xxxxxlxD    xxD |  UxxD        Ux|xxxxxlxxxxxxxxxx|xx            xx|
xxxxxxxlxxxxxxxx|xxxxxxxlxxxxDUxx|xxxlxxxxxxxxxxxx|xxxxxxxxxxxxxxxx|xxxxxxxxxxxxxxxx|xxxxxxxxxxxxxxxx|xxxxxxxDUxxxxxxx|xxxxlxxxxxxxxxxx|xxxxxxxDUxxxxxxx|xxxxxxxxxxxxxxxx|xxxxxxxxxxxxxlxx|xxxxxxxlxxxxxxxx|xxxxxlxxxxDUxxxx|xxxxxxxxxxxxxlxx|xxxxxlxxxxxxxxxx|xxxxxxxxlxxxxxxx|
xxxxxxxlxxxxxxxx|xxxxxxxlxxxxxxxx|xxxlxxxxxxxxxxxx|xxxxxxxxxxxxxxxx|xxxxxxxxxxxxxxxx|xxxxxxxxxxxxxxxx|xxxxxxxxxxxxxxxx|xxxxlxxxxxxxxxxx|xxxxxxxxxxxxxxxx|xxxxxxxxxxxxxxxx|xxxxxxxxxxxxxlxx|xxxxxxxlxxxxxxxx|xxxxxlxxxxxxxxxx|xxxxxxxxxxxxxlxx|xxxxxlxxxxxxxxxx|xxxxxxxxlxxxxxxx|
----------------+----------------+----------------+----------------+----------------+----------------+----------------+----------------+----------------+----------------+----------------+----------------+----------------+----------------+----------------+----------------+
xxxxxxxlxxxxxxxx|xxxxxxxlxxxxxxxx|                |                |                |                |                |                |                |                |                |                |                |                |                |                |
xxxxxxxlxxxxxxxx|xxxxxxxlxxxxxxxx|                |                |                |                |                |                |                |                |                |                |                |                |                |                |
xxu             |              dx|                |                |                |                |                |                |                |                |                |                |                |                |                |                |
xu  x      xD  x|D  xD       x  x|                |                |                |                |                |                |                |                |                |                |                |                |                |                |
x     x    dx  d|x  dx     x    x|                |                |                |                |                |                |                |                |                |                |                |                |                |                |
x   x   x       |        x   x  x|                |                |                |                |                |                |                |                |                |                |                |                |                |                |
x     x     xD  |  xD      x    x|                |                |                |                |                |                |                |                |                |                |                |                |                |                |
xD  x       dx  |  dx        x  x|                |                |                |                |                |                |                |                |                |                |                |                |                |                |
xxD             |              Ux|                |                |                |                |                |                |                |                |                |                |                |                |                |                |
xxxxxxxxxxxxxxxx|xxxxxxxxxxxxxxxx|                |                |                |                |                |                |                |                |                |                |                |                |                |                |
xxxxxxxxxxxxxxxx|xxxxxxxxxxxxxxxx|                |                |                |                |                |                |                |                |                |                |                |                |                |                |
----------------+----------------+----------------+----------------+----------------+----------------+----------------+----------------+----------------+----------------+----------------+----------------+----------------+----------------+----------------+----------------+
                |                |                |                |                |                |                |                |                |                |                |                |                |                |                |                |
                |                |                |                |                |                |                |                |                |                |                |                |                |                |                |                |
                |                |                |                |                |                |                |                |                |                |                |                |                |                |                |                |
                |                |                |                |                |                |                |                |                |                |                |                |                |                |                |                |
                |                |                |                |                |                |                |                |                |                |                |                |                |                |                |                |
                |                |                |                |                |                |                |                |                |                |                |                |                |                |                |                |
                |                |                |                |                |                |                |                |                |                |                |                |                |                |                |                |
                |                |                |                |                |                |                |                |                |                |                |                |                |                |                |                |
                |                |                |                |                |                |                |                |                |                |                |                |                |                |                |                |
                |                |                |                |                |                |                |                |                |                |                |                |                |                |                |                |
                |                |                |                |                |                |                |                |                |                |                |                |                |                |                |                |
----------------+----------------+----------------+----------------+----------------+----------------+----------------+----------------+----------------+----------------+----------------+----------------+----------------+----------------+----------------+----------------+
                |                |                |                |                |                |                |                |                |                |                |                |                |                |                |                |
                |                |                |                |                |                |                |                |                |                |                |                |                |                |                |                |
                |                |                |                |                |                |                |                |                |                |                |                |                |                |                |                |
                |                |                |                |                |                |                |                |                |                |                |                |                |                |                |                |
                |                |                |                |                |                |                |                |                |                |                |                |                |                |                |                |
                |                |                |                |                |                |                |                |                |                |                |                |                |                |                |                |
                |                |                |                |                |                |                |                |                |                |                |                |                |                |                |                |
                |                |                |                |                |                |                |                |                |                |                |                |                |                |                |                |
                |                |                |                |                |                |                |                |                |                |                |                |                |                |                |                |
                |                |                |                |                |                |                |                |                |                |                |                |                |                |                |                |
                |                |                |                |                |                |                |                |                |                |                |                |                |                |                |                |
----------------+----------------+----------------+----------------+----------------+----------------+----------------+----------------+----------------+----------------+----------------+----------------+----------------+----------------+----------------+----------------+
                |                |                |                |                |                |                |                |                |                |                |                |                |                |                |                |
                |                |                |                |                |                |                |                |                |                |                |                |                |                |                |                |
                |                |                |                |                |                |                |                |                |                |                |                |                |                |                |                |
                |                |                |                |                |                |                |                |                |                |                |                |                |                |                |                |
                |                |                |                |                |                |                |                |                |                |                |                |                |                |                |                |
                |                |                |                |                |                |                |                |                |                |                |                |                |                |                |                |
                |                |                |                |                |                |                |                |                |                |                |                |                |                |                |                |
                |                |                |                |                |                |                |                |                |                |                |                |                |                |                |                |
                |                |                |                |                |                |                |                |                |                |                |                |                |                |                |                |
                |                |                |                |                |                |                |                |                |                |                |                |                |                |                |                |
                |                |                |                |                |                |                |                |                |                |                |                |                |                |                |                |
----------------+----------------+----------------+----------------+----------------+----------------+----------------+----------------+----------------+----------------+----------------+----------------+----------------+----------------+----------------+----------------+
                |                |                |                |                |                |                |                |                |                |                |                |                |                |                |                |
                |                |                |                |                |                |                |                |                |                |                |                |                |                |                |                |
                |                |                |                |                |                |                |                |                |                |                |                |                |                |                |                |
                |                |                |                |                |                |                |                |                |                |                |                |                |                |                |                |
                |                |                |                |                |                |                |                |                |                |                |                |                |                |                |                |
                |                |                |                |                |                |                |                |                |                |                |                |                |                |                |                |
                |                |                |                |                |                |                |                |                |                |                |                |                |                |                |                |
                |                |                |                |                |                |                |                |                |                |                |                |                |                |                |                |
                |                |                |                |                |                |                |                |                |                |                |                |                |                |                |                |
                |                |                |                |                |                |                |                |                |                |                |                |                |                |                |                |
                |                |                |                |                |                |                |                |                |                |                |                |                |                |                |                |
----------------+----------------+----------------+----------------+----------------+----------------+----------------+----------------+----------------+----------------+----------------+----------------+----------------+----------------+----------------+----------------+
                |                |                |                |                |                |                |xxxxxxxxxxxxxxxx|                |                |                |                |                |                |                |                |
                |                |                |                |                |                |                |xxxxxxxxxxxxxxxx|                |                |                |                |                |                |                |                |
                |                |                |                |                |                |                |xu       du   dx|                |                |                |                |                |                |                |                |
                |                |                |                |                |                |                |u  x x      x  d|                |                |                |                |                |                |                |                |
                |                |                |                |                |                |                |                |                |                |                |                |                |                |                |                |
                |                |                |                |                |                |                |   x x      x   |                |                |                |                |                |                |                |                |
                |                |                |                |                |                |                |                |                |                |                |                |                |                |                |                |
                |                |                |                |                |                |                |D  x x      x  U|                |                |                |                |                |                |                |                |
                |                |                |                |                |                |                |xD       UD   Ux|                |                |                |                |                |                |                |                |
                |                |                |                |                |                |                |xxxxxxx  xxxxxxx|                |                |                |                |                |                |                |                |
                |                |                |                |                |                |                |xxxxxxx  xxxxxxx|                |                |                |                |                |                |                |                |
----------------+----------------+----------------+----------------+----------------+----------------+----------------+----------------+----------------+----------------+----------------+----------------+----------------+----------------+----------------+----------------+
                |                |                |                |                |                |                |xxxxxxx  xxxxxxx|                |                |                |                |                |                |                |                |
                |                |                |                |                |                |                |xxxxgxu  xxxxxxx|                |                |                |                |                |                |                |                |
                |                |                |                |                |                |                |xxxu     xxxxxxx|                |                |                |                |                |                |                |                |
                |                |                |                |                |                |                |xxu      xxxxxxx|                |                |                |                |                |                |                |                |
                |                |                |                |                |                |                |xu       dxxxxxx|                |                |                |                |                |                |                |                |
                |                |                |                |                |                |                |                |                |                |                |                |                |                |                |                |
                |                |                |                |                |                |                |xD            xx|                |                |                |                |                |                |                |                |
                |                |                |                |                |                |                |xx            xx|                |                |                |                |                |                |                |                |
                |                |                |                |                |                |                |xx            xx|                |                |                |                |                |                |                |                |
                |                |                |                |                |                |                |xxxxxxxxxxxxxxxx|                |                |                |                |                |                |                |                |
                |                |                |                |                |                |                |xxxxxxxxxxxxxxxx|                |                |                |                |                |                |                |                |
----------------+----------------+----------------+----------------+----------------+----------------+----------------+----------------+----------------+----------------+----------------+----------------+----------------+----------------+----------------+----------------+







































































