xxxxxxxxxxxxxxxx|xxxxxxxxxxxxxxxx|xxxxxxxxxxxxxxxx|                |                |                |                |                |                |                |                |                |                |                |                |                |
xxxxxxxxxxxxxxxx|xxxxxxxxxxududxx|xxxxxxxxxxxxxxxx|                |                |                |                |                |                |                |                |                |                |                |                |                |
xxxxxxxxxxxxxxxx|xxdxxxxxx     xx|xxxxxxxxxxudxxxx|                |                |                |                |                |                |                |                |                |                |                |                |                |
xxxxxxxxxxxxxxxx|xu xxxxxx     dx|xxxxxxxxxx  dxxx|                |                |                |                |                |                |                |                |                |                |                |                |                |
xxxxxxxxxxxxxxxx|x  dudxxu      d|xxxxxxxxxu   dxx|                |                |                |                |                |                |                |                |                |                |                |                |                |
xxxxxxx         |                |                |                |                |                |                |                |                |                |                |                |                |                |                |                |
xxxxxxx xxxxxxxx|x              U|xxx xxxxxD      |                |                |                |                |                |                |                |                |                |                |                |                |                |
xxxxxxx xxxxxxxx|xD            Ux|xxx xxxxxx      |                |                |                |                |                |                |                |                |                |                |                |                |                |
xxxxxxx xxxxxxxx|xx            xx|xxx xxxxxxD     |                |                |                |                |                |                |                |                |                |                |                |                |                |
xxxxxxx xxxxxxxx|xxxxxxx xxxxDUxx|xxx xxxxxxxxxxxx|                |                |                |                |                |                |                |                |                |                |                |                |                |
xxxxxxx xxxxxxxx|xxxxxxx xxxxxxxx|xxx xxxxxxxxxxxx|                |                |                |                |                |                |                |                |                |                |                |                |                |
----------------+----------------+----------------+----------------+----------------+----------------+----------------+----------------+----------------+----------------+----------------+----------------+----------------+----------------+----------------+----------------+
                |                |                |                |                |                |                |                |                |                |                |                |                |                |                |                |
                |                |                |                |                |                |                |                |                |                |                |                |                |                |                |                |
                |                |                |                |                |                |                |                |                |                |                |                |                |                |                |                |
                |                |                |                |                |                |                |                |                |                |                |                |                |                |                |                |
                |                |                |                |                |                |                |                |                |                |                |                |                |                |                |                |
                |                |                |                |                |                |                |                |                |                |                |                |                |                |                |                |
                |                |                |                |                |                |                |                |                |                |                |                |                |                |                |                |
                |                |                |                |                |                |                |                |                |                |                |                |                |                |                |                |
                |                |                |                |                |                |                |                |                |                |                |                |                |                |                |                |
                |                |                |                |                |                |                |                |                |                |                |                |                |                |                |                |
                |                |                |                |                |                |                |                |                |                |                |                |                |                |                |                |
----------------+----------------+----------------+----------------+----------------+----------------+----------------+----------------+----------------+----------------+----------------+----------------+----------------+----------------+----------------+----------------+
                |                |                |                |                |                |                |                |                |                |                |                |                |                |                |                |
                |                |                |                |                |                |                |                |                |                |                |                |                |                |                |                |
                |                |                |                |                |                |                |                |                |                |                |                |                |                |                |                |
                |                |                |                |                |                |                |                |                |                |                |                |                |                |                |                |
                |                |                |                |                |                |                |                |                |                |                |                |                |                |                |                |
                |                |                |                |                |                |                |                |                |                |                |                |                |                |                |                |
                |                |                |                |                |                |                |                |                |                |                |                |                |                |                |                |
                |                |                |                |                |                |                |                |                |                |                |                |                |                |                |                |
                |                |                |                |                |                |                |                |                |                |                |                |                |                |                |                |
                |                |                |                |                |                |                |                |                |                |                |                |                |                |                |                |
                |                |                |                |                |                |                |                |                |                |                |                |                |                |                |                |
----------------+----------------+----------------+----------------+----------------+----------------+----------------+----------------+----------------+----------------+----------------+----------------+----------------+----------------+----------------+----------------+
                |                |                |                |                |                |                |                |                |                |                |                |                |                |                |                |
                |                |                |                |                |                |                |                |                |                |                |                |                |                |                |                |
                |                |                |                |                |                |                |                |                |                |                |                |                |                |                |                |
                |                |                |                |                |                |                |                |                |                |                |                |                |                |                |                |
                |                |                |                |                |                |                |                |                |                |                |                |                |                |                |                |
                |                |                |                |                |                |                |                |                |                |                |                |                |                |                |                |
                |                |                |                |                |                |                |                |                |                |                |                |                |                |                |                |
                |                |                |                |                |                |                |                |                |                |                |                |                |                |                |                |
                |                |                |                |                |                |                |                |                |                |                |                |                |                |                |                |
                |                |                |                |                |                |                |                |                |                |                |                |                |                |                |                |
                |                |                |                |                |                |                |                |                |                |                |                |                |                |                |                |
----------------+----------------+----------------+----------------+----------------+----------------+----------------+----------------+----------------+----------------+----------------+----------------+----------------+----------------+----------------+----------------+
                |                |                |                |                |                |                |                |                |                |                |                |                |                |                |                |
                |                |                |                |                |                |                |                |                |                |                |                |                |                |                |                |
                |                |                |                |                |                |                |                |                |                |                |                |                |                |                |                |
                |                |                |                |                |                |                |                |                |                |                |                |                |                |                |                |
                |                |                |                |                |                |                |                |                |                |                |                |                |                |                |                |
                |                |                |                |                |                |                |                |                |                |                |                |                |                |                |                |
                |                |                |                |                |                |                |                |                |                |                |                |                |                |                |                |
                |                |                |                |                |                |                |                |                |                |                |                |                |                |                |                |
                |                |                |                |                |                |                |                |                |                |                |                |                |                |                |                |
                |                |                |                |                |                |                |                |                |                |                |                |                |                |                |                |
                |                |                |                |                |                |                |                |                |                |                |                |                |                |                |                |
----------------+----------------+----------------+----------------+----------------+----------------+----------------+----------------+----------------+----------------+----------------+----------------+----------------+----------------+----------------+----------------+
                |                |                |                |                |                |                |                |                |                |                |                |                |                |                |                |
                |                |                |                |                |                |                |                |                |                |                |                |                |                |                |                |
                |                |                |                |                |                |                |                |                |                |                |                |                |                |                |                |
                |                |                |                |                |                |                |                |                |                |                |                |                |                |                |                |
                |                |                |                |                |                |                |                |                |                |                |                |                |                |                |                |
                |                |                |                |                |                |                |                |                |                |                |                |                |                |                |                |
                |                |                |                |                |                |                |                |                |                |                |                |                |                |                |                |
                |                |                |                |                |                |                |                |                |                |                |                |                |                |                |                |
                |                |                |                |                |                |                |                |                |                |                |                |                |                |                |                |
                |                |                |                |                |                |                |                |                |                |                |                |                |                |                |                |
                |                |                |                |                |                |                |                |                |                |                |                |                |                |                |                |
----------------+----------------+----------------+----------------+----------------+----------------+----------------+----------------+----------------+----------------+----------------+----------------+----------------+----------------+----------------+----------------+
                |                |                |                |                |                |                |xxxxxxxxxxxxxxxx|                |                |                |                |                |                |                |                |
                |                |                |                |                |                |                |xxxxxxxxxxxxxxxx|                |                |                |                |                |                |                |                |
                |                |                |                |                |                |                |xu       du   dx|                |                |                |                |                |                |                |                |
                |                |                |                |                |                |                |u  x x      x  d|                |                |                |                |                |                |                |                |
                |                |                |                |                |                |                |                |                |                |                |                |                |                |                |                |
                |                |                |                |                |                |                |   x x      x   |                |                |                |                |                |                |                |                |
                |                |                |                |                |                |                |                |                |                |                |                |                |                |                |                |
                |                |                |                |                |                |                |D  x x      x  U|                |                |                |                |                |                |                |                |
                |                |                |                |                |                |                |xD       UD   Ux|                |                |                |                |                |                |                |                |
                |                |                |                |                |                |                |xxxxxxx  xxxxxxx|                |                |                |                |                |                |                |                |
                |                |                |                |                |                |                |xxxxxxx  xxxxxxx|                |                |                |                |                |                |                |                |
----------------+----------------+----------------+----------------+----------------+----------------+----------------+----------------+----------------+----------------+----------------+----------------+----------------+----------------+----------------+----------------+
                |                |                |                |                |                |                |xxxxxxx  xxxxxxx|                |                |                |                |                |                |                |                |
                |                |                |                |                |                |                |xxxxgxu  xxxxxxx|                |                |                |                |                |                |                |                |
                |                |                |                |                |                |                |xxxu     xxxxxxx|                |                |                |                |                |                |                |                |
                |                |                |                |                |                |                |xxu      xxxxxxx|                |                |                |                |                |                |                |                |
                |                |                |                |                |                |                |xu       dxxxxxx|                |                |                |                |                |                |                |                |
                |                |                |                |                |                |                |                |                |                |                |                |                |                |                |                |
                |                |                |                |                |                |                |xD            xx|                |                |                |                |                |                |                |                |
                |                |                |                |                |                |                |xx            xx|                |                |                |                |                |                |                |                |
                |                |                |                |                |                |                |xx            xx|                |                |                |                |                |                |                |                |
                |                |                |                |                |                |                |xxxxxxxxxxxxxxxx|                |                |                |                |                |                |                |                |
                |                |                |                |                |                |                |xxxxxxxxxxxxxxxx|                |                |                |                |                |                |                |                |
----------------+----------------+----------------+----------------+----------------+----------------+----------------+----------------+----------------+----------------+----------------+----------------+----------------+----------------+----------------+----------------+







































































