xxxxxxxxxxxxxxxx|xxxxxxxxxxxxxxxx|xxxxxxxxxxxxxxxx|xxxxxxxxxxxxxxxx|xxxxxxxxxxxxxxxx|xxxxxxxxxxxxxxxx|xxxxxxxxxxxxxxxx|xxxxxxxxxxxxxxxx|xxxxxxxxxxxxxxxx|xxxxxxxxxxxxxxxx|xxxxxxxxxxxxxxxx|xxxxxxxxxxxxxxxx|xxxxxxxxxxxxxxxx|xxxxxxxxxxxxxxxx|xxxxxxxxxxxxxxxx|xxxxxxxxxxxxxxxx|
xxxxxxxxxxxxxxxx|xxxxxxxxxxududxx|xxxxxxxxxxxxxxxx|xudxxxxxxxxxxxxx|xxxxxxxxxxxxgxxx|xxxxxxxxxxxxxxxx|xxxxxxxudxxxxxxx|xxxxxxxxxxxxxxxx|xxxxxxxudxxxxxxx|xxxxxxxxxxxxxxxx|xxgxxxxxxxxxxxxx|xxxxxxxxxxxxudxx|xxxxxxxxgxudxxxx|xxxxxxudxxxxxxxx|xxxxxxxxxxxxxxxx|xxxxxxxxxxxxxxxx|
xxxxxxxxxxxxxxxx|xxdxxxxxx     xx|xxxxxxxxxxudxxxx|x  dxxxxxxxxxxxx|xxxxxxxxxxu    d|udu           dx|xxxxudu  dxxxxxx|xxxxxxxxxxxxxxxx|xxxxudu  dxxxxxx|xudu         dxx|xu            dx|xxu           dx|xxxxxxxu    xxu |  dxxu    dxxxxx|xxxxxxxxxxxxxxxx|xx            xx|
xxxxxxxxxxxxxxxx|xu xxxxxx     dx|xxxxxxxxxx  dxxx|x   dxxxxxxxxxxx|xxxxxxxxxu      |    UD    UD   x|xxxu      xxxxxx|xxxxxxxudxxxxxxx|xxxu      xxxxxx|x     x       dx|x  wwwwwwwww   x|xu    UxD      x|xxxxxxx     du  |   du      dxxxx|xxxxxxxxxxxxxxxx|xx  UD UxD UD xx|
xxxxxxxxxxxxxxxx|x  dudxxu      d|xxxxxxxxxu   dxx|u    dxxxxxxxxxx|xxxxudxxu       |   UxxD  UxxD  d|udu       dududx|xxxxxxu  dxxudxx|udu       dududx|u    x         x|x  wwwwwwwww   x|x  m mxgxm m   x|xxxxxxu         |            dxxx|xxxxxgxxxxxxxxxx|xx  xx xgx xx xx|
xxxxxxx         |                |                |           xxxxx|xu    du        |   xxxx  xxxx   |                |                |                |    x x x x x  x|x  wwwwwwwww   x|x              x|xxxxx           |              dx|xxxxx xxxxxxxxxx|xx            xx|
xxxxxxxlxxxxxxxx|x              U|xxxlxxxxxD      |     Uxxxxlxxxxx|x               |   dxxu  dxxu  U|DUD       UDUDUx|xxxxlxD  UxxDUxx|DUD       UDUDUx|D    x         x|x  wwwwwwwww   x|x  m m   m m   x|xxxxxlD         |               x|xxxxx xxxxxxxxxx|xx            xx|
xxxxxxxlxxxxxxxx|xD            Ux|xxxlxxxxxx      |    Uxxxxxlxxxxx|x               |               x|xxxD      xxxxxx|xxxxlxxDUxxxxxxx|xxxD      xxxxxx|x     x       Ux|x     w        x|xD             x|xxxxxlx     UD  |   UD          x|xxxxx xxxxxxxxxx|xx            xx|
xxxxxxxlxxxxxxxx|xx            xx|xxxlxxxxxxD     |   Uxxxxxxlxxxxx|xD    UD       U|DUD           Ux|xxxxDUD  Uxxxxxx|xxxxlxxxxxxxxxxx|xxxxDUD  Uxxxxxx|xDUD         Uxx|xD    w       Ux|xxD           Ux|xxxxxlxD    xxD |  UxxD        Ux|xxxxxlxxxxxxxxxx|xx            xx|
xxxxxxxlxxxxxxxx|xxxxxxxlxxxxDUxx|xxxlxxxxxxxxxxxx|xxxxxxxxxxxxxxxx|xxxxxxxxxxxxxxxx|xxxxxxxxxxxxxxxx|xxxxxxxDUxxxxxxx|xxxxlxxxxxxxxxxx|xxxxxxxDUxxxxxxx|xxxxxxxxxxxxxxxx|xxxxxxwxxxxxxlxx|xxxxxxxlxxxxxxxx|xxxxxlxxxxDUxxxx|xxxxxxxxxxxxxlxx|xxxxxlxxxxxxxxxx|xxxxxxxxlxxxxxxx|
xxxxxxxlxxxxxxxx|xxxxxxxlxxxxxxxx|xxxlxxxxxxxxxxxx|xxxxxxxxxxxxxxxx|xxxxxxxxxxxxxxxx|xxxxxxxxxxxxxxxx|xxxxxxxxxxxxxxxx|xxxxlxxxxxxxxxxx|xxxxxxxxxxxxxxxx|xxxxxxxxxxxxxxxx|xxxxxxwxxxxxxlxx|xxxxxxxlxxxxxxxx|xxxxxlxxxxxxxxxx|xxxxxxxxxxxxxlxx|xxxxxlxxxxxxxxxx|xxxxxxxxlxxxxxxx|
----------------+----------------+----------------+----------------+----------------+----------------+----------------+----------------+----------------+----------------+----------------+----------------+----------------+----------------+----------------+----------------+
xxxxxxxlxxxxxxxx|xxxxxxxlxxxxxxxx|xxxlxxxxxxxxxxxx|xxxxxxxxxxlxxxxx|xxxxxxxxxxxxxxxx|xxxxxxxxxxxxxxxx|xxxxxxxxxxxxxxxx|xxxxlxxxxxxxxxxx|xxxxxxxxxxxxxxxx|xxxxxxxxxxxxxxxx|xxxxxxwxxxxxxlxx|xxxxxxxlxxxxxxxx|xxxxxlxxxxxxxxxx|xxxxxxxxxxxxxlxx|xxxxxlxxxxxxxxxx|xxxxxxxx xxxxxxx|
xxxxxxxlxxxxxxxx|xxxxxxxlxxxxxxxx|xxxlxxxxxxxxxxxx|xxxxxxxxxxlxxxxx|xudxxxxxxxxxxxxx|xxxxxxxxudxxxxxx|xxudxxxxxxxxxxxx|udxxlxxxxxxxxxxx|xxxxxxxxxxxxxxxx|xxxxxxxxxxxxxxxx|xxxxxxwxxxxxxlxx|xxxxxxxlxxxxxxxx|xxxxxlxxxxxxxxxx|xxxxxxxxxxxxxlxx|xxxxxlxxxxxxxxxx|xxxxxxxx xxxxxxx|
xxu             |              dx|xxxlxxxu        |   dxxxxxxlxxxu |              dx|xxxxxxxx  du  du|du  du  xxxxxxu |  dxlxxxxxxxxxxx|xxxxxxxxxxxxxxxx|xxxxxxxxxxxxxxxx|xxxxxxwxxxxxxlxx|xxu          dxx|xu              |    dxxxxxxxxlxx|xxxxxlxxxu      |              xx|
xu  x      xD  x|D  xD       x  x|xxxlxxu  xD xD x|D   dxxxxxlxxu  |               x|xxxxxxxx        |        xxxxxu  |   xlxxxxxxxxxxx|xxxxxxxxxxxxxxxx|xxxxxxxxxxxxxxxx|xxxxxxwxxxxxxlxx|xx   x        xx|x               |     xxxxxudxlxx|xxxxxlxxx       |  xD xxD  xD  xx|
x     x    dx  d|x  dx     x    x|xxxlxu   dx dx d|x    dxxxxlxu   |   m  m  m   m d|xxxxxxxd        |        dxudu   |   dlxwwwwwwwwww|wwwwwwwwwwwwwwww|wwwwwwwwwwwwwwww|wwwwwwgxxxxxxlxx|xu x    x x   dx|u      m m m m  |     xxxxx      |       xx       |  dx dgx  dx  xx|
x   x   x       |        x   x  x|xu              |                |                | du  du         |                |      w         |                |                |                |     x      x   |                |   x xu         |                |              xx|
x     x     xD  |  xD      x    x|x         xD xD |                |   m  m  m   m  |                |           UD   |      w         |                |                |               x|xD x    x x   Ux|D      m m m m  |     x   wwwwwww|wwwwwwwxx       |    xD  xD xD xx|
xD  x       dx  |  dx        x  x|x         dx dx |                |                |                |           xxD  |      w         |        xxxxxxxx|xxxxxxxxxxxxxxxx|xxxxxxx        x|xx   x        xx|x               |     x   wwwwwww|wwwwwwwxx       |    dx  dx dx xx|
xxD             |              Ux|xD              |                |                | UD  UD   UD  UD|UD  UD     xxxD |      w         |        xxxxxxxx|xxxxxxxxxxxxxxxx|xxxxxxx        x|xxD          Uxx|xD              |    UxD  wwwwwww|wwwwwwwxx       |              xx|
xxxxxxxxxxxxxxxx|xxxxxxxxxxxxxxxx|xxxxxxxxxxxxxxxx|xxxxxxxxxxxxxxxx|xDUxxxxxxxlxxxxx|xxxlxxxxDUxxxlxx|xxDUxxxxxxxxxxxx|xxxxxxw    xxxxx|xxxxxxxxxxxxxxxx|xxxxxxxxxxxxxxxx|xxxxxxxxxxxxxxxx|xxxxxxxxxxxxxxxx|xxxlxxxxxxxxxxxx|xxlxxxx  wwwwwww|wwwwwwwxxxxxxxxx|xxxxxxxxxxxxxxxx|
xxxxxxxxxxxxxxxx|xxxxxxxxxxxxxxxx|xxxxxxxxxxxxxxxx|xxxxxxxxxxxxxxxx|xxxxxxxxxxlxxxxx|xxxlxxxxxxxxxlxx|xxxxxxxxxxxxxxxx|xxxxxxw    xxxxx|xxxxxxxxxxxxxxxx|xxxxxxxxxxxxxxxx|xxxxxxxxxxxxxxxx|xxxxxxxxxxxxxxxx|xxxlxxxxxxxxxxxx|xxlxxxx  wwwwwww|wwwwwwwxxxxxxxxx|xxxxxxxxxxxxxxxx|
----------------+----------------+----------------+----------------+----------------+----------------+----------------+----------------+----------------+----------------+----------------+----------------+----------------+----------------+----------------+----------------+
                |                |                |                |                |                |                |                |                |                |                |                |                |                |                |                |
                |                |                |                |                |                |                |                |                |                |                |                |                |                |                |                |
                |                |                |                |                |                |                |                |                |                |                |                |                |                |                |                |
                |                |                |                |                |                |                |                |                |                |                |                |                |                |                |                |
                |                |                |                |                |                |                |                |                |                |                |                |                |                |                |                |
                |                |                |                |                |                |                |                |                |                |                |                |                |                |                |                |
                |                |                |                |                |                |                |                |                |                |                |                |                |                |                |                |
                |                |                |                |                |                |                |                |                |                |                |                |                |                |                |                |
                |                |                |                |                |                |                |                |                |                |                |                |                |                |                |                |
                |                |                |                |                |                |                |                |                |                |                |                |                |                |                |                |
                |                |                |                |                |                |                |                |                |                |                |                |                |                |                |                |
----------------+----------------+----------------+----------------+----------------+----------------+----------------+----------------+----------------+----------------+----------------+----------------+----------------+----------------+----------------+----------------+
                |                |                |                |                |                |                |                |                |                |                |                |                |                |                |                |
                |                |                |                |                |                |                |                |                |                |                |                |                |                |                |                |
                |                |                |                |                |                |                |                |                |                |                |                |                |                |                |                |
                |                |                |                |                |                |                |                |                |                |                |                |                |                |                |                |
                |                |                |                |                |                |                |                |                |                |                |                |                |                |                |                |
                |                |                |                |                |                |                |                |                |                |                |                |                |                |                |                |
                |                |                |                |                |                |                |                |                |                |                |                |                |                |                |                |
                |                |                |                |                |                |                |                |                |                |                |                |                |                |                |                |
                |                |                |                |                |                |                |                |                |                |                |                |                |                |                |                |
                |                |                |                |                |                |                |                |                |                |                |                |                |                |                |                |
                |                |                |                |                |                |                |                |                |                |                |                |                |                |                |                |
----------------+----------------+----------------+----------------+----------------+----------------+----------------+----------------+----------------+----------------+----------------+----------------+----------------+----------------+----------------+----------------+
                |                |                |                |                |                |                |                |                |                |                |                |                |                |                |                |
                |                |                |                |                |                |                |                |                |                |                |                |                |                |                |                |
                |                |                |                |                |                |                |                |                |                |                |                |                |                |                |                |
                |                |                |                |                |                |                |                |                |                |                |                |                |                |                |                |
                |                |                |                |                |                |                |                |                |                |                |                |                |                |                |                |
                |                |                |                |                |                |                |                |                |                |                |                |                |                |                |                |
                |                |                |                |                |                |                |                |                |                |                |                |                |                |                |                |
                |                |                |                |                |                |                |                |                |                |                |                |                |                |                |                |
                |                |                |                |                |                |                |                |                |                |                |                |                |                |                |                |
                |                |                |                |                |                |                |                |                |                |                |                |                |                |                |                |
                |                |                |                |                |                |                |                |                |                |                |                |                |                |                |                |
----------------+----------------+----------------+----------------+----------------+----------------+----------------+----------------+----------------+----------------+----------------+----------------+----------------+----------------+----------------+----------------+
                |                |                |                |                |                |                |                |                |                |                |                |                |                |                |                |
                |                |                |                |                |                |                |                |                |                |                |                |                |                |                |                |
                |                |                |                |                |                |                |                |                |                |                |                |                |                |                |                |
                |                |                |                |                |                |                |                |                |                |                |                |                |                |                |                |
                |                |                |                |                |                |                |                |                |                |                |                |                |                |                |                |
                |                |                |                |                |                |                |                |                |                |                |                |                |                |                |                |
                |                |                |                |                |                |                |                |                |                |                |                |                |                |                |                |
                |                |                |                |                |                |                |                |                |                |                |                |                |                |                |                |
                |                |                |                |                |                |                |                |                |                |                |                |                |                |                |                |
                |                |                |                |                |                |                |                |                |                |                |                |                |                |                |                |
                |                |                |                |                |                |                |                |                |                |                |                |                |                |                |                |
----------------+----------------+----------------+----------------+----------------+----------------+----------------+----------------+----------------+----------------+----------------+----------------+----------------+----------------+----------------+----------------+
                |                |                |                |                |                |                |xxxxxxxxxxxxxxxx|                |                |                |                |                |                |                |                |
                |                |                |                |                |                |                |xxxxxxxxxxxxxxxx|                |                |                |                |                |                |                |                |
                |                |                |                |                |                |                |xu       du   dx|                |                |                |                |                |                |                |                |
                |                |                |                |                |                |                |u  x x      x  d|                |                |                |                |                |                |                |                |
                |                |                |                |                |                |                |                |                |                |                |                |                |                |                |                |
                |                |                |                |                |                |                |   x x      x   |                |                |                |                |                |                |                |                |
                |                |                |                |                |                |                |                |                |                |                |                |                |                |                |                |
                |                |                |                |                |                |                |D  x x      x  U|                |                |                |                |                |                |                |                |
                |                |                |                |                |                |                |xD       UD   Ux|                |                |                |                |                |                |                |                |
                |                |                |                |                |                |                |xxxxxxx  xxxxxxx|                |                |                |                |                |                |                |                |
                |                |                |                |                |                |                |xxxxxxx  xxxxxxx|                |                |                |                |                |                |                |                |
----------------+----------------+----------------+----------------+----------------+----------------+----------------+----------------+----------------+----------------+----------------+----------------+----------------+----------------+----------------+----------------+
                |                |                |                |                |                |                |xxxxxxx  xxxxxxx|                |                |                |                |                |                |                |                |
                |                |                |                |                |                |                |xxxxgxu  xxxxxxx|                |                |                |                |                |                |                |                |
                |                |                |                |                |                |                |xxxu     xxxxxxx|                |                |                |                |                |                |                |                |
                |                |                |                |                |                |                |xxu      xxxxxxx|                |                |                |                |                |                |                |                |
                |                |                |                |                |                |                |xu       dxxxxxx|                |                |                |                |                |                |                |                |
                |                |                |                |                |                |                |                |                |                |                |                |                |                |                |                |
                |                |                |                |                |                |                |xD            xx|                |                |                |                |                |                |                |                |
                |                |                |                |                |                |                |xx            xx|                |                |                |                |                |                |                |                |
                |                |                |                |                |                |                |xx            xx|                |                |                |                |                |                |                |                |
                |                |                |                |                |                |                |xxxxxxxxxxxxxxxx|                |                |                |                |                |                |                |                |
                |                |                |                |                |                |                |xxxxxxxxxxxxxxxx|                |                |                |                |                |                |                |                |
----------------+----------------+----------------+----------------+----------------+----------------+----------------+----------------+----------------+----------------+----------------+----------------+----------------+----------------+----------------+----------------+







































































